111111111
111111111
111100111
111101111
111101111
111101111
111101111
111101111
111111111