111111111
111111111
111111111
111110311
111100111
111001111
110011111
112111111
111111111